R 640 480

NO ./srcs/imgs/NO.xpm
WE ./srcs/imgs/WE.xpm
SO ./srcs/imgs/SO.xpm
EA ./srcs/imgs/EA.xpm
S  ./srcs/imgs/SPRITE.xpm

C  250,0,0
F  0,250,0

1111111111
1S0000000111111
100000200022001
100000200111101
1000012101  101
1000001001  101
1111111111  101
            101
            101
            101
           1001
            111