R 640 480

NO ./srcs/imgs/Johny2.xpm
WE ./srcs/imgs/Johny2.xpm
SO ./srcs/imgs/Johny2.xpm
EA ./srcs/imgs/Johny2.xpm
S  ./srcs/imgs/Johny2.xpm

C  200,200,200
F  100,100,100

1111111111
1000000001
1000010001
1000101011
1001000101
1000000001
1111111111
