R 1920 1080

NO ./srcs/imgs/Johny2.xpm
WE ./srcs/imgs/Johny2.xpm
EA ./srcs/imgs/Johny2.xpm
SO ./srcs/imgs/Johny2.xpm
S ./srcs/imgs/Johny2.xpm

F 100,100,100
C 200,200,200

1111111111
1000000001
1000000001
1000000001
1001001001
1000000001
1111111111
