R 640 480

NO ./srcs/imgs/NO.xpm
WE ./srcs/imgs/WE.xpm
SO ./srcs/imgs/SO.xpm
EA ./srcs/imgs/EA.xpm
S  ./srcs/imgs/SPRITE.xpm

C  250,0,0
F  0,250,0

1111111111
1000000001
1000002001
1000002001
1000012101
1000001001
1111111111
