R 640 480

NO ./imgs/rainbow1.xpm
WE ./imgs/rainbow1.xpm
SO ./imgs/rainbow1.xpm
EA ./imgs/rainbow1.xpm
S  ./imgs/ponyhead.xpm
HF ./imgs/forelock.xpm
HW ./imgs/wand.xpm

C  135,206,235
F  244,164,96

111111111111111111
10002000W000000001
100000000000200001
100002000000000001
100002000000000001
100000000020200001
100000000000200001
100000220000000001
100000000000000001
100002000020020001
100000000000000001
111111111111111111
