R 1000 800


NO ./imgs/NO.xpm
WE ./imgs/WE.xpm
SO ./imgs/SO.xpm
EA ./imgs/EA.xpm
S  ./imgs/SPRITE.xpm

C  135,206,235
F  244,164,96

1111111111
10002000W1
1000000001
1000100001
1000000001
1111111111
