R 640 420


NO ./imgs/plant_wall.xpm
WE ./imgs/plant_wall.xpm
SO               ./imgs/plant_wall.xpm
EA ./imgs/plant_wall.xpm
S  ./imgs/SPRITE.xpm

C  135,206,235
F  244,164,96

1111111111
10002000W111111
100000000122001
100000000111101
1000000001  101
1000000001  101
1111111111  111
