R 640 480

NO ./imgs/NO.xpm
WE ./imgs/WE.xpm
SO ./imgs/SO.xpm
EA ./imgs/EA.xpm
S  ./imgs/SPRITE.xpm

C  250,0,0
F  0,250,0

11111111111111111111111111111111111111
10000000000000000000000000000000000001
10000000000001111111111111111000000001
10000000000001111111111111111000000001
10000000000000000000000000000000000001
10000000100000000111000000001000000001
10000001 100000001 1000000001110000001
10000001 10000000111000111000010000001
100000011101111000000001 1000010000001
100000000001  1000N00001 1000010000001
10001110000111100000000111000110000001
10001 10000000000000000000000100000001
10001 10000011111111111111110100000001
10001 1000001        0     10100000001
10001 10000011111111111111110100000001
10001110000000000000000000000100000001
10000000000000000000000000000100000001
10001111111111111111111111111100000001
10000000000000000000000000000000000001
11111111111111111111111111111111111111


