R 640 480

NO ./imgs/NO.xpm
WE ./imgs/WE.xpm
SO ./imgs/SO.xpm
EA ./imgs/EA.xpm
S  ./imgs/SPRITE.xpm

C  250,0,0
F  0,250,0

1111111111
1E0020000111111
100000000122001
100000000111101
1000000001  101
1000000001  101
1111111111  101
            101
            101
            101
           1001
            111